6x7 2
*-*-*-*-*-*-*
|   |   |   |
*-* *-* *-*-*
  |         |
*-* *-* * *-*
|     | | |
*-*-* *-*-*-*
    |   |   |
*-* *-*-* *-*
|   | |     |
*-*-* *-*-*-*