4x5 1
*-*-*-*-*
|   |   |
*-* *-* *
  | |    
*-* *-* *
|     | |
*-*-*-*-*

*-* *-* *-* *-* *-*
|.. ... ... ... ..|
*.* *.* *.* *-* *-*

*.* *-* *.* *-* *.*
|.. ..| |.. ..| |.|
*-* *.* *.* *-* *-*

*-* *.* *.* *-* *-*
|.. ..| |.. ..| |.|
*.* *-* *-* *.* *.*

*.* *.* *.* *.* *.*
|.. ... ... ... ..|
*-* *-* *-* *-* *-*