10x9 4
*-*-*-*-*-*-*-*-*
|   |   |   |   |
*-* *-* *-*-* *-*
            |   |
*-* *-* *-*-* *-*
|   | |   |   |
*-*-* *-*-*-* *-*
  |     |      |
*-* *-* * *-*-*-*
|   | |     | |  
*-*-* *-*-*-* *-*
|   |       |   |
* *-* *-*-* *-* *
|     |   | | | |
*-*-*-*-* *-* *-*
  |       |     |
*-* *-* *-* * *-*
  | | | | | | | |
*-*-* *-* *-*-* *