10x11 4
*-*-*-*-*-*-*-*-* *-*
|   |   |   |   | | |
*-* *-* * *-* *-* * *
        |   |   | | |
*-* *-*-* *-* *-*-* *
|   | |   |   |     |
*-*-* *-*-*-* *-* *-*
  |     |      |  | |
*-* *-* * *-*-*-* * *
|   | |     | |   |
*-*-* *-* *-* *-* *-*
|   |   |   |   | |
* *-* *-*-* *-* *-*-*
|     |   | | | |   |
*-*-*-*-* *-* *-* * *
  |       |     | |
*-* *-*-*-* * *-* * *
  | |   | | |   | | |
*-*-* *-* *-*-* *-*-*