4x4 1
*-*-*-*
|     |
*-* *-*
  | |  
*-* *-*
|     |
*-*-*-*

*-* *-* *-* *-*
|.. ..| |.. ..|
*.* *.* *.* *.*

*.* *.* *.* *.*
|.. |.. ..| ..|
*.* *-* *-* *.*

*.* *-* *-* *.*
|.. |.. ..| ..|
*.* *.* *.* *.*

*.* *.* *.* *.*
|.. ..| |.. ..|
*-* *-* *-* *-*