6x5 2
*-*-*-*-*
|   |   |
*-* *-* *
  | |    
*-* *-* *
|     | |
*-*-* *-*
    |   |
*-* * *-*
|   | |
*-*-* *-*