8x7 3
*-*-*-*-*-*-*
|   |   |   |
*-* *-* *-*-*
  |         |
*-* *-* * *-*
|   | | | |
*-*-* *-*-*-*
        |   |
*-* *-*-* *-*
|   | |     |
*-*-* *-*-*-*
|   |       |
* *-*-*-*-* *
|     |   | |
*-*-*-*-* *-*