8x9 3
*-*-*-*-*-*-*-*-*
|   |   |   |   |
*-* *-* *-*-* *-*
  |         |   |
*-* *-* *-*-* *-*
|   | |   |   |
*-*-* *-*-*-* *-*
        |   |   |
*-* *-* * *-*-*-*
|   | |     | |  
*-*-* *-*-*-* *-*
|   |       |   |
* *-*-*-*-* *-* *
|     |   | | | |
*-*-*-*-* *-* *-*